1111111111111111111
100001C100000000001
100001010000000P001
1000000C00C00000001
100E000000000000001
1111111111111111111
