1111111111111111111111
1P00000000000000000001
10000001001C1111000001
1000000100100001000001
1000000111101111000001
1000000000101000000001
1000000000101111000001
10000000000000000000E1
1111111111111111111111
